{
  "base": [
    " ==================      ",
    "=..................=     ",
    "=.================.=     ",
    "=.= ============ =.=     ",
    "=.==............==.=     ",
    "=.==.==========.==.=     ",
    "=.==.= ===    =.==.= === ",
    "=.==.==...=== =.==.==...=",
    "=.==.==.S....==.==....E.=",
    "=.==.==...==.==.= ===...=",
    "=.==.= === =.==.=    === ",
    "=.==.=======.==.=        ",
    "=.==.........==.=        ",
    "=.= ========= =.=        ",
    "=.=============.=        ",
    "=...............=        ",
    " ===============         "
  ],
  "config": {

  },
  "links": [],
  "meta": {
    "name": "Movement",
    "size": [
      25,
      17
    ]
  },
  "objects": [],
  "overlay": [
    "                         ",
    "                         ",
    "                         ",
    "                         ",
    "                         ",
    "                         ",
    "                         ",
    "                         ",
    "                         ",
    "                         ",
    "                         ",
    "                         ",
    "                         ",
    "                         ",
    "                         ",
    "                         ",
    "                         "
  ],
  "version": 1
}