{
  "base": [
    "                           #    ...",
    "                           .    .E.",
    "                                ...",
    "                      #            ",
    "                      .    .       ",
    "                                   ",
    "...                                ",
    ".S.    .    .    .    .   .        ",
    "...                                ",
    "                                   ",
    "                      .            "
  ],
  "config": {

  },
  "links": [],
  "meta": {
    "name": "Dodge",
    "size": [
      35,
      11
    ]
  },
  "objects": [],
  "overlay": [
    "                                   ",
    "                                   ",
    "                                   ",
    "                                   ",
    "                                   ",
    "                                   ",
    "                                   ",
    "                                   ",
    "                                   ",
    "                                   ",
    "                                   "
  ],
  "version": 1
}